###########################
#............#............#
#.####.#####.#.#####.####.#
#.####.#####.#.#####.####.#
#.####.#####.#.#####.####.#
#.........................#
#.####.##.#######.##.####.#
#......##....#....##......#
#.####....##.#.##....####.#
#...##.##.##.#.##.##.##...#
###.....#.##.#.##.#.....###
#...##.##.#..#..#.##.##...#
#.####....#.###.#....####.#
#.......#.........#.......#
#.#####...#######...#####.#
#.#.....#.#     #.#.....#.#
#.#####.#.#######.#.#####.#
#.......#.........#.......#
######.##.### ###.##.######
#............#............#
#.####.#####.#.#####.####.#
#.####.#####.#.#####.####.#
#...##...............##...#
###.##.#.#########.#.##.###
#......#.....#.....#......#
#.##########.#.##########.#
#.........................#
###########################